ooo ooo ooo ooo --- --- --- ooo --- --- --- ooo ooo ooo ooo
ooo PPP t01 ooo --- --- --- ooo --- --- --- ooo t00 t0t ooo
ooo ooo ooo ooo ooo ooo ooo ooo ooo ooo ooo ooo ooo ooo ooo
--- --- --- --- --- --- ooo ggg ooo --- --- --- --- --- ---
--- --- --- --- --- --- ooo ooo ooo --- --- --- --- --- ---
