---          t1tt00t41 ---       --- --- ---    --- --- --- --- ooo ooo ooo
t4tt01t20t31 ooo       t2tt21t40 b20 b30 S00t11 S01 t10 b21 b31 ooo ggg ooo
---          t3tt30    ---       --- --- ---    --- --- --- --- ooo ooo ooo
---          ---       ---       --- --- ---    --- --- --- --- --- --- ---
---          ---       ---       --- --- ---    --- --- --- --- --- --- ---
---          ---       ooo       ooo ooo ---    --- --- ooo ooo ooo --- ---
---          ---       ooo       PPP ooo ooo    ooo ooo ooo t0t ooo --- ---
---          ---       ooo       ooo ooo ---    --- --- ooo ooo ooo --- ---
