--- --- --- --- --- --- --- --- --- --- ooo ooo ooo ooo
--- --- --- b30 ooo ooo ooo ooo ooo ooo ooo S01 ooo t0t
--- PPP b21 b31 ooo S02 ooo --- --- --- ooo ooo ooo ooo
S00 ooo --- --- ooo ooo --- --- --- --- --- --- ooo ---
ooo ooo --- --- ooo --- --- --- --- --- --- --- ooo ---
ooo ooo ooo ooo ooo --- --- --- --- --- ooo ooo ooo ---
ooo ooo ooo --- --- t00 ooo t01 b23 b33 ooo ggg ooo ---
--- --- --- --- --- S03 ooo b22 --- --- ooo ooo ooo ---
