--- --- --- --- --- ooo ooo ooo ooo --- ---    --- --- t0t
--- --- --- --- --- ooo ooo s20 ooo ooo ooo    --- --- ooo
--- --- --- --- ooo ooo ooo ooo ooo ooo ooo    --- --- ooo
ooo ooo B20 B30 ooo ooo ooo ooo --- --- ooo    ooo t00 ooo
ooo ooo ooo b21 --- --- ooo --- --- --- ooo    ooo --- ---
ooo ooo ooo --- --- --- ooo --- --- --- PPPt01 --- --- ---
--- ooo --- --- --- --- ooo ooo ooo --- ---    --- --- ---
--- S01 --- --- --- --- ooo ggg ooo b21 ---    --- --- ---
--- --- --- --- --- --- ooo ooo ooo --- ---    --- --- ---
